CIB - CENTRO DE INVESTIGACIÓN EN BIOTECNOLOGÍA,biología,biologia,biology,biotecnología,biotecnologia,biotechnology,biotech,cib,biotecnologia,biol,biotecnol,biotechnol,biological,biotechnological
CIC - CENTRO DE INVESTIGACIONES EN COMPUTACIÓN,inclutec,computación,computacion,computer,comp,cic
CIF - CENTRO DE INVESTIGACIÓN EN INNOVACIÓN FORESTAL,forestal,forestry,forest,cif,ecoplant
CIPA - CENTRO DE INVESTIGACIÓN EN PROTECCIÓN AMBIENTAL,cipa
CIVCO - CENTRO DE INVESTIGACIÓN EN VIVIENDA Y CONSTRUCCIÓN,construccion,construcción,building,vivienda,dwelling,structure,civco,construcc
CIDASTH - CENTRO DE INVESTIGACIÓN Y DESARROLLO EN AGRICULTURA SOSTENIBLE PARA EL TRÓPICO HÚMEDO,agronomia,agronomía,agronomıa,agronomy,agr,cidasth,plantations
CIGA - CENTRO DE INVESTIGACIÓN Y GESTIÓN AGROINDUSTRIAL,agroindustrial,agronegocios,agribusiness,ciga,agropecuaria,agricultural
CEQIATEC - CENTRO DE INVESTIGACIÓN Y DE SERVICIOS QUÍMICOS Y MICROBIOLÓGICOS,quimica,química,chemistry,microbiologicos,microbiológicos,ceqiatec,quim
CIEMTEC - CENTRO DE INVESTIGACIÓN Y EXTENSIÓN EN MATERIALES,materiales,materials,ciemtec
CIADEGTEC - CENTRO DE INVESTIGACIÓN EN ADMINISTRACIÓN, ECONOMÍA Y GESTIÓN TECNOLÓGICA,business,ciadeg-tec
ATI - AREA DE ADMINISTRACION DE TECNOLOGIA DE INFORMACIÓN,ati
AU - ESCUELA ARQUITECTURA Y URBANISMO,au
CD - ESCUELA DE CULTURA Y DEPORTE,cd
CDA - CENTRO DE DESARROLLO ACADEMICO,cda
CI - ESCUELA DE CIENCIAS DEL LENGUAJE,ci
CIT - CENTRO DE VINCULACIÓN,cit
DOCINADE,zootecnia,docinade,cnd
CS - ESCUELA DE CIENCIAS SOCIALES,cs
DOP - ORIENTACION Y PSICOLOGIA,dop
DP - AREA ACADEMICA DE DOCTORADO EN INGENIERIA,dp
E - ESCUELA DE INGENIERIA EN ELECTRONICA,electronica,electrónica,elect
ECE - ESCUELA DE CIENCIAS NATURALES Y EXACTAS,ece
EIC - ESCUELA DE IDIOMAS Y CIENCIAS SOCIALES,eic
FI - ESCUELA DE FISICA,física,fisica,physics,physical,fis
GPM - AREA ACADEMICA DE GERENCIA DE PROYECTOS,gpm
IDC - INGENIERIA EN COMPUTADORES,computadores,idc
IMT - AREA ACADEMICA INGENIERIA MECATRONICA,Mecatronica,mechatronics,mecatron,imt
MA - ESCUELA DE MATEMATICA,matematica,matemática,mathematics,matemat
MI - ESCUELA DE INGENIERIA ELECTROMECANICA,electromecánica,electromecanica,electromechanical,electromecan
MRN - AREA ACADEMICA AGROFORESTAL,agroforestry,agroforestal
OEG - PROGRAMA DE EQUIDAD DE GENERO,genero,género,gender
Laboratorio de Ergonomia,ergonomia
Laboratotorio de Plasma,plasma